1111111111111111111111111111111111111111111111111111111111111111111111111111111111111111111
1010010010101010001001000000000000000000000000000000000000000000000000000000000000000000001
1010010010101010001001000000000000000000000000000000000000000000000000000000000000000000001
1010010010101010001000000E00000000000000000000000000000000000000000000000000000000000000001
1010010010101010001000000000000000000000000000000000000000000000000000000000000000000000001
1010010010101010001000000000000000000000000000000000000000000000000000000000000000000000001
1010010010101010001000000000000011111111000000000000000000000000000000000000000000000000001
101001001010101000100000000000000000C001100000000000000000000000000000000000000000000000001
1010010010101010001000000000000011111111100000000000000000000000000000000000000000000000001
1010010010101010001000000000000000000000000000000000000000000000000000000000000000000000001
1010010010101010001000000000000000000000000000000000000000000000000000000000000000000000001
1010010010101P10001000000000000000000000000000000000000000000000000000000000000000000000001
1010010010101010000000000000000000000000000000000000000000000000000000000000000000000000001
1000000000000010001000000000000000000000000000000000000000000000000000000000000000000000001
1010010010101000001000000000000000000000000000000000000000000000000000000000000000000000001
1010010010101010001000000000000000000000000000000000000000000000000000000000000000000000001
1010010010101010001000000000000000000000000000000000000000000000000000000000000000000000001
1111111111111111111111111111111111111111111111111111111111111111111111111111111111111111111