11111111111111111111111111
10100101001110001010010001
10100100100110101010010001
1P0001000C10C000100C000001
100001000010000C10000C00011
1110010100100C001010010001
10100100101010100010010001
1C0000000C00100C00000C0001
11111111111111111111111111