11111111111111111111111111
10100101001E10001010010001
10100100101010100010010001
1P0000000C00C000000C000001
100000000000000C00000C0001
1010010100100C001010010001
10100100101010100010010001
1C0000000C00100C00000C0001
11111111111111111111111111