11111111111111111111111111
10100001001C10001010010001
1010010010101E101010010001
1P0001001C001110100C000001
100001001000001C10000C0001
1010010010100C101010010001
10100100101010100010010001
1C000100C00100C00000C00001
11111111111111111111111111