11111111111111111111111111
10101101001C10001010000001
1010110110101C101010111001
1P0100011C001110100C101001
100001011000101C10011C0001
1010110010101C101011011101
10101100101000100010010101
1E000100C00100C00010C00001
11111111111111111111111111