11111111111
10000000001
1C0P0100001
1E000000001
11111111111
