11111111111111111111111111
10110101001110001010010001
101E0100100110101010010001
10010100001000001000000001
10000P00001000001000000001
11100101001000C11010010001
101001001010101C1010010001
100000000000100100C01C0001
11111111111111111111111111