11111111111111111111111111
11111101001110001010010001
110E0100100110101010010001
11111100001000001000000001
10000P00001000001000000001
11100101001000C01010010001
101001001010101C1010010001
100000000000100C00C00C0001
11111111111111111111111111