11111111111111111111111111
10100101001E10001010010001
10100100100010101010010001
1P0001000C10C0001?0C000001
100001000010000C10000C0001
1110010100100C001010010001
101001001010S010!010010001
1C0000000C00100C00000C0001
11111111111111111111111111