11111111111111111111111111
10110101001110001010010001
101E1100100110101010010001
10000100001000001000000001
10000P00001000001000000001111
11100101001000C01010010001
101001001010101C10100100011
100000000000100C00C00C0001
11111111111111111111111111