11111111011111111111111111
10100101001110001010010001
001E0100100110101010010001
10000100001000001000000000
10000P00001000001000000001
11100101001000C01010010001
101001001010101C1010010001
100000000000100C00C00C0001
11111111011111111111111111