11111111111111111111111111
10100101001110001010010001
101E0100100110101010010001
10000100001000001000000001
10000P00001000001000000001
11100101001000001010010001
10100100101010101010010001
10000000000010000000000001
11111111111111111111111111